,Sales & Marketing,Engineering Research & Development,Customer Services,Business Operations,Leadership,Other,total_jobs
ericsson,1,32,0,5,21,0,59
honeywell,5,23,1,22,24,0,75
jpmorgan chase,0,0,4,25,0,0,29
on target staffing,0,0,6,0,17,0,23
target,0,3,0,43,1,0,47
target building inspections,0,1,0,0,0,0,1
all on target,0,0,0,0,0,0,0
action target,0,0,0,0,0,0,0
hp manufacturing,0,0,0,0,9,0,9
hp,6,15,1,16,10,0,48
hp legacy care group,0,0,0,0,1,0,1
hp hood llc,0,1,0,1,2,0,4
hp hood,0,0,0,0,5,0,5
hp transportation,0,0,0,0,0,4,4
hp diagnostics,0,0,0,0,0,0,0
wipro limited,0,17,4,20,1,0,42
wipro,0,3,3,2,2,0,10
wipro ltd,1,11,0,2,2,0,16
matrix resources,0,9,0,6,1,0,16
ibm,10,21,0,6,12,0,49
modis it,0,0,0,0,4,0,4
modis architects,0,4,0,0,5,0,9
walmart,1,1,25,1,23,8,59
walmart dc7012,0,0,0,0,4,0,4
walmart dc 7077,0,0,0,0,1,0,1
acosta - walmart,2,0,0,0,0,0,2
walmart super-center,0,0,0,0,0,0,0
walmart 2768,0,0,0,0,0,0,0
walmart ecommerce,0,0,0,0,0,0,0
"walmart neighborhood market- northport, al",0,0,1,0,0,0,1
"walmart eau claire, wi",0,0,0,0,0,0,0
walmart distribution center,0,0,0,0,0,0,0
"walmart ""moline""",0,0,0,0,0,0,0
cellular sales,5,0,0,0,0,0,5
reno's trailer sales/tnt sales,4,0,0,0,0,0,4
norwood sales inc,0,0,0,0,4,0,4
american industrial sales,4,0,0,0,0,0,4
vandahl engineering & sales,0,0,0,0,0,0,0
get fresh sales,0,0,0,0,0,0,0
sales executives,0,0,0,0,0,0,0
cobra car sales inc.,0,0,0,0,0,0,0
redrover sales & marketing strategy,0,0,0,0,3,0,3
xojet sales,0,0,0,0,0,1,1
thrifty car sales,0,0,0,0,0,0,0
asb sales,0,0,0,0,0,0,0
"total sales & marketing, inc.",4,0,0,0,0,0,4
penn tool sales and service,4,0,0,0,0,0,4
ohio truck sales,0,0,0,0,0,0,0
faines auto sales,3,0,0,0,0,0,3
vmware sales,1,0,0,0,0,0,1
home sales,0,0,0,0,0,0,0
camacho auto sales,0,0,0,0,0,0,0
pacwest sales group,1,0,0,0,0,0,1
rnc sales of tampa bay,0,0,0,0,0,0,0
sales recruiters network,1,0,0,0,0,0,1
copper brass sales na,0,0,0,0,0,0,0
white industries auto sales,0,0,0,0,0,0,0
"keyimpact sales & systems, inc",0,0,0,0,0,0,0
arizona car sales,0,0,0,0,1,0,1
ba food sales,1,0,0,0,0,0,1
modern auto sales,0,0,0,0,0,0,0
one of a kind sales,0,0,0,0,0,0,0
hgv waikoloa sales & marketing,0,0,0,0,0,0,0
sunshine solar sales group,0,0,0,0,0,0,0
metal sales manufacturing corporation,0,0,0,0,0,0,0
midco sales,0,0,0,0,0,0,0
thermal resource sales,0,0,1,0,0,0,1
"heat transfer sales of the carolinas, inc",0,0,0,0,0,0,0
taymar sales u.,0,0,0,0,0,0,0
cox sales group,1,0,0,0,0,0,1
pharmaceutical sales solutions,0,0,0,0,0,0,0
seaside sales & marketing llc,0,0,0,0,0,0,0
precision estate sales,0,0,0,0,0,0,0
the adecco group - u.s.,0,2,2,5,0,0,9
ey,0,32,1,40,9,0,82
unisys,1,29,3,22,15,1,71
unisys federal systems,0,0,0,0,0,0,0
apex imports,0,0,0,0,0,4,4
apex surface care,0,0,0,0,4,0,4
"apex machining, inc.",0,0,0,0,4,0,4
apex security and convention services inc,0,0,0,0,0,2,2
apex learning inc.,0,0,0,0,2,0,2
apex performance,0,0,0,0,0,0,0
apex driving school,0,0,1,0,0,0,1
apex windows and bath accessories,2,0,1,0,0,2,5
apex human resources,0,0,0,0,0,0,0
apex microtechnology,0,1,0,0,0,0,1
"apex companies, llc",0,2,0,0,0,0,2
apex aseptic products,5,0,0,0,0,0,5
apex fabrication and design,0,0,0,0,4,0,4
apex behavioral consulting,0,0,0,0,1,0,1
apex restoration dki,0,0,1,0,2,1,4
apex industrial battery,1,0,0,0,0,0,1
apex clean energy,0,1,0,0,0,0,1
teknor apex company,0,1,0,0,3,0,4
apex global solutions,0,0,0,0,1,0,1
"apex leaders, llc",0,0,0,0,0,0,0
"apex behavioral consulting, llc",0,0,0,0,0,0,0
apex construction group,0,0,0,0,1,0,1
apex quality assurance,0,0,0,0,0,0,0
apex digital solutions,0,0,0,0,0,0,0
"apex international mfg, inc.",0,0,0,0,0,0,0
apex wraps,0,0,0,0,0,0,0
apex benefits group,0,0,0,1,0,0,1
apex life sciences,0,2,0,0,0,0,2
"apex marine, inc.",0,0,0,0,0,0,0
apex real estate network,0,0,0,0,0,0,0
apex tool group,0,0,0,0,0,0,0
microsoft,6,12,3,18,10,0,49
genpact,1,8,10,21,7,0,47
genpact it,0,0,3,3,0,0,6
ctg,0,19,7,4,5,0,35
ctg corporate,13,5,0,0,0,0,18
ctg (computer task group),0,9,0,2,0,0,11
ctg consulting group,0,4,0,0,0,0,4
ctg int'l north america inc,0,0,0,0,4,0,4
deutsche bank,0,16,0,31,0,0,47
"deutsche precision, llc",0,0,0,0,1,0,1
cgi strategies,0,6,0,20,0,0,26
"cgi group, inc.",0,21,8,15,4,0,48
cgi corp,0,0,0,0,0,0,0
cgi interactive,0,0,0,0,0,0,0
cgi management inc,0,0,0,0,0,0,0
cgi communications,0,0,0,0,0,0,0
bae systems,0,32,0,28,9,0,69
"bae industries, inc.",0,3,0,0,2,0,5
fidelity investments,1,0,36,6,6,0,49
collabera,4,0,0,0,0,0,4
google,0,18,1,17,7,0,43
google fiber,0,4,0,1,0,0,5
barclays,0,0,14,0,0,0,14
barclays rehabilitation and health care center,0,0,0,0,44,0,44
adp,32,8,3,28,4,0,75
an adp client,1,0,0,1,0,0,2
"adp construction, inc.",0,0,0,0,0,0,0
us ut 583 w ebay way-draper,0,0,0,0,1,0,1
ebay inc.,1,19,1,23,3,0,47
"xray on wheels, inc",0,0,0,0,0,4,4
mobile xray provider,0,0,0,0,0,9,9
intel,0,46,0,2,0,0,48
sigma intel,0,0,0,0,0,0,0
tech mahindra,0,23,0,1,2,0,26
tech mahindra americas,0,4,4,3,7,0,18
tech mahindra ltd,0,2,0,1,0,0,3
mckesson,4,3,10,29,12,1,59
kelly box and packaging corporation,3,0,0,0,0,0,3
kelly supply company,4,0,0,0,0,0,4
kelly services,0,0,8,0,5,0,13
kelly kritter clips,0,0,0,0,0,0,0
metro kelly inc.,0,0,2,0,0,0,2
kelly d. nails and spa,0,0,0,0,0,0,0
"kelly cable of n.m., llc.",0,1,0,1,1,0,3
sean kelly,0,0,0,0,0,0,0
kelly cable,0,3,0,2,4,0,9
kelly box & packaging,0,0,0,0,2,0,2
"kelly logistics, llc - a dsp company that delivers packages for amazon",0,0,0,0,0,3,3
kelly products,0,0,0,1,0,0,1
kelly - measured progress,0,0,0,0,0,0,0
the kelly companies,0,0,0,0,0,0,0
the law offices of amy sholar & kelly stephan,0,0,0,0,0,0,0
the kelly group,0,3,0,0,0,0,3
"kelly generator & equipment, inc.",0,0,0,0,0,0,0
monica kelly & co.,0,0,0,0,0,0,0
monsignor kelly catholic high school,0,0,0,0,1,0,1
kelly government/national institutes of health,0,0,0,0,0,0,0
kelly cooper homes,0,0,0,0,0,0,0
kelly+co | kelly co homes,0,0,0,0,0,0,0
perry kelly plumbing inc.,0,0,0,0,0,0,0
kelly community fcu,0,0,0,0,0,0,0
kelly wellness and chiropractic,0,0,0,0,0,0,0
kelly government,0,0,0,0,0,0,0
"jerry kelly heating and air conditioning , inc.",0,0,0,0,0,0,0
mike kelly automotive,0,0,0,0,0,0,0
deloitte,0,17,0,52,9,0,78
robert half,0,9,8,11,3,0,31
robert half corporate internal,0,16,2,24,2,0,44
enlyft,0,4,0,0,0,0,4
kpmg,1,34,0,20,11,0,66
leidos,0,64,3,11,0,0,78
leidos cyber,0,0,0,0,0,0,0
csc (corporation service company),2,6,19,13,13,0,53
csc transportation,0,4,0,6,1,0,11
csc services,0,0,0,0,0,0,0
csc serviceworks,0,0,1,5,1,1,8
"contemporary services corporation, csc",0,0,0,0,0,0,0
csc steil dermatology,0,0,0,0,0,0,0
csc,0,0,0,0,0,0,0
csc management,0,0,0,0,0,0,0
"siemens manufacturing co., inc.",0,5,0,4,0,0,9
siemens,4,22,12,7,3,0,48
"siemens industry, inc.",0,0,0,0,0,0,0
bank of america,5,3,7,16,3,0,34
levy at bank of america stadium,0,0,0,0,0,0,0
bloomberg,19,19,7,10,12,0,67
bloomberg associates,0,0,0,0,0,0,0
bloomberg bna,10,3,0,1,0,0,14
(insert your company name here),0,0,4,0,0,0,4
randstad,10,0,2,5,17,8,42
randstad professionals,0,5,4,5,0,0,14
randstad usa,0,0,4,1,0,0,5
randstad staffing,0,0,0,0,4,0,4
randstad engineering,1,0,1,0,0,0,2
caring hearts animal clinic,0,0,0,0,4,0,4
animal care hospital of phoenix,5,0,0,0,0,0,5
power road animal hospital,0,0,4,0,0,0,4
applewood animal hospital,4,0,0,0,0,0,4
cardiff animal hospital & wellness center,0,0,0,0,4,0,4
great hearts animal hospital of chandler,0,0,0,0,0,0,0
vca animal hospitals,1,0,1,0,5,0,7
arizona animal welfare league,0,0,1,0,0,4,5
animal medical & surgical center,0,0,0,0,0,0,0
the wild animal sanctuary,0,0,0,0,0,0,0
arizona skies animal hospital,0,0,0,0,0,0,0
casa grande animal hospital,0,0,4,0,0,0,4
arizona animal wellness center,0,0,0,0,0,0,0
east mesa animal hospital,0,0,0,0,0,0,0
orangewood animal hospital,0,0,0,0,0,0,0
best friends animal hospital,0,0,0,0,0,0,0
aspen ridge animal hospital,0,0,0,0,0,0,0
mountain animal hospital center,0,0,0,0,0,0,0
animal medical center,0,0,0,0,0,0,0
mckinney animal hospital,0,0,0,0,0,0,0
penny paws animal clinic,0,0,0,0,0,0,0
virbac animal health,0,0,0,0,0,0,0
the animal league central florida humane society,0,0,0,0,0,0,0
guardian animal medical center,0,0,0,0,0,0,0
best friends animal society,0,0,0,0,0,0,0
kaibab animal hospital,0,0,2,0,0,0,2
young-williams animal center of east tennessee,0,0,0,0,0,0,0
scottsdale animal healthcare,0,0,0,0,0,0,0
farr west animal hospital,0,0,0,0,0,0,0
ambassador animal hospital,0,0,0,0,0,0,0
emerald coast animal hospital,0,0,0,0,0,0,0
copeland road animal hospital,0,0,0,0,0,0,0
chico animal hospital,1,0,0,0,0,0,1
animal samaritans society for the prevention of cr...,0,0,0,0,0,0,0
lifecare animal hospital,0,0,0,0,0,0,0
the animal foundation,0,0,0,0,0,0,0
forever vets animal hospital,0,0,0,0,0,0,0
animal care hospital,0,0,0,0,0,0,0
animal caretaker,0,0,0,0,0,0,0
ocotillo animal clinic and pet resort,0,0,0,0,0,0,0
rifle animal shelter,0,0,0,0,0,0,0
frankfort animal care center,0,0,0,0,0,0,0
hayden road animal hospital,0,0,0,0,0,0,0
newport harbor animal hospital,0,0,0,0,0,0,0
"parc, a xerox company",0,8,0,0,0,0,8
xerox corporation,1,10,0,9,1,0,21
"xerox copy solutions, inc.",1,2,0,1,0,0,4
xerox,1,0,2,0,0,0,3
xerox business solutions southwest,2,0,2,0,0,1,5
"electronic systems, inc. a xerox company",0,0,0,0,0,0,0
"cotg, motg, a xerox company",1,0,0,0,0,0,1
"mbm, a xerox company",0,0,0,0,0,0,0
citi,1,13,3,43,7,0,67
citi open,0,0,0,2,4,0,6
citi trends,0,0,0,0,1,0,1
unitedhealth group,2,2,60,9,4,0,77
johnson & johnson family of companies,2,11,1,1,1,0,16
johnson storage & moving,0,0,0,0,0,0,0
american express company,5,0,0,4,0,0,9
american express,0,16,3,17,5,0,41
american express global business travel,2,0,3,1,4,0,10
blue cross and blue shield of nebraska (bcbsne),0,0,0,0,0,0,0
blue cross and blue shield of nebraska,0,0,0,0,0,0,0
blue cross blue shield of arizona,0,3,2,18,5,0,28
blue cross blue shield of massachusetts,0,0,1,0,0,0,1
blue cross and blue shield of kansas city,0,0,0,0,2,0,2
horizon blue cross blue shield of new jersey,0,0,0,1,0,0,1
blue cross and blue shield of alabama,0,0,0,0,2,0,2
blue cross & blue shield of mississippi,0,0,1,2,0,0,3
blue cross blue shield of michigan,0,0,0,2,0,0,2
excellus blue cross blue shield,0,0,0,0,0,0,0
blue cross blue shield of north dakota,0,0,0,0,0,0,0
cognizant technology solutions,0,17,4,9,19,0,49
earth tek engineering corp,0,3,0,0,0,2,5
novation tek,0,0,0,4,0,0,4
tek bay,0,1,0,0,0,0,1
quik tek assembly llc,0,5,0,0,0,0,5
ariston tek inc,0,3,0,3,1,0,7
tek leaders,0,4,0,3,0,0,7
global pharma tek,0,2,0,0,0,0,2
tek leaders inc,0,0,0,0,0,0,0
miracles tek,0,0,0,0,0,0,0
tek experts,0,2,0,1,0,0,3
tek wissen llc,1,1,0,1,0,0,3
tek yantra inc,0,1,0,0,1,0,2
tek on demand,0,0,0,0,0,0,0
tek ninjas solutions,0,0,0,0,0,0,0
tek ninjas,0,1,0,0,0,0,1
sure3 tek,0,0,0,0,0,0,0
droit tek solutions,0,1,0,0,0,0,1
"bay tek games, inc.",0,0,0,0,0,0,0
amazon workforce staffing,0,0,0,0,0,27,27
amazon runs,0,0,0,0,0,0,0
amazon retail llc,0,0,0,1,0,0,1
amazon hvh,0,0,0,0,0,3,3
amazon support services costa rica srl,0,0,0,0,0,0,0
amazon studios llc,0,0,0,0,0,0,0
amazon dsp,0,0,0,0,0,1,1
jre logistics - amazon dsp,0,0,0,0,0,0,0
general dynamics electric boat,0,5,0,0,0,0,5
c3i solutions an hcl technologies company,0,0,4,2,0,0,6
hcl technologies,2,6,7,6,0,0,21
hcl americas,2,10,0,3,21,8,44
hcl america,0,1,0,0,0,0,1
hcl america inc,0,0,0,0,0,0,0
justice resource institute/dys zara cisco,0,0,0,0,3,0,3
cisco systems,13,10,7,12,5,0,47
cisco environmental,0,0,0,0,0,4,4
cisco talos intelligence group,0,0,0,0,0,0,0
cisco meraki,0,0,0,0,0,0,0
atos - syntel,0,2,0,0,0,0,2
atos,6,16,1,12,2,1,38
atos syntel,0,0,0,0,1,0,1
atos medical us,0,0,0,0,0,0,0
oracle,16,12,2,12,5,1,48
oracle cloud sales service cpq functional,0,0,0,0,0,0,0
experis (manpowergroup),0,0,0,0,0,4,4
experis manpowergroup,0,14,0,10,0,0,24
booz allen hamilton,0,36,0,7,6,0,49
general dynamics information technology,0,24,2,2,12,1,41
infosys limited,0,19,0,18,13,0,50
infosys bpm limited,0,0,0,4,0,0,4
infosys,0,13,0,1,0,0,14
hsv infosys,1,1,0,0,1,0,3
infosys mccamish,0,0,0,2,0,0,2
"infosys public services, inc",0,1,0,0,0,0,1
nokia,1,46,0,1,1,0,49
tata technologies,0,28,0,8,0,0,36
tata chemicals,0,0,0,0,1,0,1
tata communications,5,3,0,2,0,0,10
tata elxsi,2,4,0,0,0,0,6
tata consumer products,0,1,0,0,0,0,1
tata chemical limited,0,0,0,0,0,0,0
tata enterprises,0,0,0,0,0,0,0
tata technologies inc.,0,10,0,1,0,0,11
tata communications limited,0,0,0,0,0,0,0
dell,34,24,1,9,1,0,69
chick-fil-a - dell range,0,0,0,0,0,0,0
emc insurance,0,24,3,5,8,0,40
emc energy,4,0,0,0,0,0,4
caring senior service of emc,0,0,0,0,0,1,1
emc foundations inc.,0,0,0,0,0,0,0
upson emc,0,0,0,0,0,0,0
emc bowery,0,0,0,0,0,0,0
alpha emc,0,0,0,0,8,0,8
quinlan emc,0,0,0,0,0,0,0
accenture,0,24,15,29,13,0,81
kaiser foundation health plan of the mid-atlantic,0,4,0,1,2,0,7
capgemini,3,12,1,50,2,0,68
capgemini government solutions,0,1,0,1,3,0,5
sogeti capgemini,0,0,0,0,0,0,0
ciber global,0,14,0,0,0,0,14
global wireless - at&t authorized retailer,4,0,0,0,0,0,4
at&t,6,14,26,11,6,0,63
my wireless at&t,3,0,0,1,0,0,4
prime communications | at&t,0,0,0,0,0,0,0
at&t authorized retailer - prime communications,0,0,0,0,0,0,0
prime communications at&t authorized retailer,0,0,0,0,0,0,0
at&t portables,1,0,0,0,0,0,1
sap,2,7,0,36,1,0,46
learn sap,0,0,0,1,0,0,1
wilbur sap group,0,0,0,0,0,0,0
united states army,9,11,0,3,20,14,57
"united states army, active duty & army reserves",6,0,0,0,1,0,7
united states army / army reserve,0,7,0,0,0,0,7
"department of defense, united states army",0,0,0,0,0,0,0
united states army & army reserve,0,0,0,1,0,0,1
united states army and army reserve,0,0,0,1,1,0,2
"united states army, army reserves",0,0,0,0,0,0,0
united states army recruiting center dearborn,0,0,0,0,0,0,0
united states army reserve (working 2 days a month...,0,0,0,0,0,0,0
pricewaterhousecoopers advisory services llc,0,0,0,9,0,0,9
netsource demo contracting company,0,4,0,0,0,0,4
lockheed martin,0,7,0,4,14,0,25
lockheed martin corporation,0,14,3,9,22,1,49
confidential,14,2,11,13,28,3,71
confidential [plastics],0,0,0,1,0,0,1
quick and confidential,0,0,0,0,0,1,1
confidential commercial real estate company,0,0,0,0,0,0,0
confidential - commercial cleaning company,0,0,0,0,0,0,0
confidential - dental office,0,4,0,0,0,0,4
confidential real estate & management office,0,0,0,0,3,0,3
saic,0,60,1,13,4,1,79
hewlett packard enterprise,10,13,0,24,2,0,49
capital one - us,0,0,3,5,2,0,10
one william street capital,0,0,0,0,0,0,0
tcc verizon authorized retailer,29,0,0,0,0,0,29
verizon authorized retailer - cellular plus,6,0,0,0,0,0,6
verizon wireless retailer,19,0,0,0,0,0,19
verizon authorized retailer - gowireless,2,0,0,1,0,0,3
verizon,2,4,1,7,5,0,19
verizon authorized retailer – gowireless,1,0,0,0,0,0,1
verizon wireless premium retailer - cellular exper...,0,0,0,0,0,0,0
victra - verizon wireless premium retailer,2,0,0,0,0,0,2
im wireless- verizon wireless authorized retailer,1,0,0,0,0,0,1
verizon wireless premium retailer - victra,0,0,0,0,0,0,0
wireless zone - verizon authorized retailer,0,0,1,0,0,0,1
kforce,1,25,5,33,11,0,75
